1111111111111
1C000000000C1
1100011100001
1P0001E000001
1111111111111