1111111111111
1C010000000C1
1000001110101
1P0001E000001
1111111111111